0000000000
0222222220
0200020020
0202020020
0200022220
0200000020
0202002020
0200000020
0222212220
0000000000