0000000000
0022202020
0000022000
0020020120
0002002020
0222020200
0202002000
0222220200
0000202000
0000000000