0000000000
0000202000
0000200000
0000002200
0002221000
0000000200
0002200000
0000202200
0000000000
0000000000