0000000000
0000002220
0000002000
0000200200
0000202200
0002220220
0020000200
0222000220
0022210000
0000000000