0000000000
0000222100
0022000000
0000222000
0202020200
0222020000
0200000200
0202000000
0202022220
0000000000