0000000000
0202222200
0202020000
0020222020
0202020200
0020020020
0202220200
0220010020
0200202020
0000000000