0000000000
0222202210
0000202000
0000202000
0222202220
0200000020
0200000020
0222202220
0000000000
0000000000