0000000000
0022202000
0000022200
0002001000
0002022200
0022002000
0002002000
0002000000
0000000000
0000000000