0000000000
0202020020
0002000000
0202020220
0022202200
0000000200
0200220000
0210020200
0202220000
0000000000