0000000000
0002000000
0002000000
0022200000
0002020000
0020010200
0220222200
0020000200
0000000000
0000000000