0000000000
0000000000
0020220200
0020020200
0022201000
0020000000
0002022200
0020202000
0000000000
0000000000