0000000000
0000000000
0010000000
0222020200
0000202200
0000200200
0022222000
0020202200
0000002000
0000000000