0000000000
0000002220
0000202200
0222220000
0020210200
0000002200
0000000200
0020222200
0222020000
0000000000