0000000000
0022220020
0202000020
0220002020
0202002000
0022102020
0000002000
0002022200
0000000000
0000000000