0000000000
0020202020
0202220220
0020200020
0202000200
0000020200
0021220200
0020000200
0000000000
0000000000