0000000000
0000000000
0000002000
0002022200
0000001000
0002000000
0022202000
0002000000
0000000000
0000000000