0200000000
0222200000
0200021200
0200000000
0202220000
0000200000
0222200000
0000000000
0000000000
0000000000