0000000000
0202020000
0220222020
0000020020
0000221000
0000020020
0000200020
0022202020
0002220020
0000000000