0000000000
0020220200
0220000000
0202202020
0002020200
0200202020
0202201220
0200202000
0002022000
0000000000