0000000000
0202020220
0020202020
0202020000
0020202220
0022020200
0222100200
0020000000
0000000000
0000000000