0000000000
0000002000
0000002020
0000002000
0000222220
0000202000
0020200020
0212020000
0020022020
0000000000