0000000000
0200000000
0202020200
0100020200
0000020200
0000000200
0222000000
0000022200
0002222200
0000000000