0000000000
0000022200
0020200200
0022120000
0000000200
0002222000
0000000200
0000002200
0000000000
0000000000