0000000000
0000020000
0222020020
0002222120
0020000000
0222020020
0020220220
0000020000
0022020200
0000000000