0000000000
0000202000
0020222220
0020202000
0222001020
0020022220
0002000000
0000222000
0002020000
0000000000