0000000000
0222202020
0000002220
0002200200
0000022200
0220202000
0002022000
0200000000
0122220000
0000000000