0000000000
0002020000
0002002200
0000020000
0222200200
0000010000
0000200200
0000222200
0000020200
0000000000