0000000000
0000020000
0022222100
0020020000
0020020000
0220022200
0200000200
0222222200
0000000000
0000000000