0000000000
0000000200
0020000100
0020022200
0220022000
0020020000
0002202000
0222000000
0202000000
0000000000